,rank,points,goalsDiff,group,form,status,description,update,team.id,team.name,team.logo,all.played,all.win,all.draw,all.lose,all.goals.for,all.goals.against,home.played,home.win,home.draw,home.lose,home.goals.for,home.goals.against,away.played,away.win,away.draw,away.lose,away.goals.for,away.goals.against
0,1,72,43,Veikkausliiga,WDWDW,same,UEFA Champions League Qualifiers,2018-02-15T00:00:00+00:00,649,HJK helsinki,https://media.api-sports.io/football/teams/649.png,33,21,9,3,65,22,17,12,4,1,37,8,16,9,5,2,28,14
1,2,59,14,Veikkausliiga,WWLDW,same,UEFA Europa League,2018-02-15T00:00:00+00:00,689,SJK,https://media.api-sports.io/football/teams/689.png,33,16,11,6,40,26,16,10,4,2,23,10,17,6,7,4,17,16
2,3,58,22,Veikkausliiga,WWDWL,same,UEFA Europa League,2018-02-15T00:00:00+00:00,1166,FC Lahti,https://media.api-sports.io/football/teams/1166.png,33,15,13,5,45,23,17,8,6,3,25,13,16,7,7,2,20,10
3,4,48,5,Veikkausliiga,WDWWD,up,,2018-02-15T00:00:00+00:00,650,vaasa PS,https://media.api-sports.io/football/teams/650.png,33,13,9,11,39,34,17,7,4,6,23,18,16,6,5,5,16,16
4,5,48,-6,Veikkausliiga,WLDWL,down,,2018-02-15T00:00:00+00:00,587,IFK Mariehamn,https://media.api-sports.io/football/teams/587.png,33,14,6,13,49,55,17,9,3,5,32,25,16,5,3,8,17,30
5,6,44,0,Veikkausliiga,WWLLW,up,,2018-02-15T00:00:00+00:00,2075,FF Jaro,https://media.api-sports.io/football/teams/2075.png,33,12,8,13,47,47,16,6,4,6,19,24,17,6,4,7,28,23
6,7,44,0,Veikkausliiga,LDWLD,down,,2018-02-15T00:00:00+00:00,1165,KuPS,https://media.api-sports.io/football/teams/1165.png,33,11,11,11,44,44,16,8,4,4,22,16,17,3,7,7,22,28
7,8,39,-13,Veikkausliiga,LDLWD,same,,2018-02-15T00:00:00+00:00,2243,MyPa,https://media.api-sports.io/football/teams/2243.png,33,10,9,14,41,54,17,8,7,2,34,23,16,2,2,12,7,31
8,9,36,-5,Veikkausliiga,LDWLD,same,,2018-02-15T00:00:00+00:00,1164,Inter Turku,https://media.api-sports.io/football/teams/1164.png,33,8,12,13,42,47,16,6,6,4,22,18,17,2,6,9,20,29
9,10,35,-10,Veikkausliiga,LLLDL,same,,2018-02-15T00:00:00+00:00,1167,Rops,https://media.api-sports.io/football/teams/1167.png,33,10,5,18,34,44,16,6,3,7,17,15,17,4,2,11,17,29
10,11,31,-19,Veikkausliiga,LDDDD,same,,2018-02-15T00:00:00+00:00,1169,Honka,https://media.api-sports.io/football/teams/1169.png,33,6,13,14,38,57,17,5,8,4,21,23,16,1,5,10,17,34
11,12,24,-31,Veikkausliiga,LLLLL,same,Relegation,2018-02-15T00:00:00+00:00,1168,Turku PS,https://media.api-sports.io/football/teams/1168.png,33,6,6,21,29,60,16,5,3,8,19,26,17,1,3,13,10,34
